# # # # # # # # # # # # # # # # # #
# p . * . . . . ? # . . . * . # ? #
# . . # # # . # # # * # . # . . . #
# # . # ? # . * . x . # . # * # # #
# . . . . # # # . . . # ? # . . ? #
# * # # # # ? # # # # # # # . # # #
# . . . # . . # . . . * . . . . . #
# # # . # . # # . # # # * # # # . #
# ? . . # . . * . . ? # . . ? # b #
# # # # # # # # # # # # # # # # # #